###########---###########
#W...W......W......W...W#
#.......................#
#..###################..#
#..W..#W....W....W#..W..#
#.....#...#...#...#.....#
###..##...#...#...##..###
#W...W....#.@.#....W...W#
###########___###########