#########################
#..D........L........D..#
#.......D.......D.......#
#.......................#
#..D.D.D.D.D.D.D.D.D.D..#
#.......................#
#.......................#
#..D.................D..#
#...........@...........#
###########___###########