###########---###########
###########...###########
###########...###########
##.......##...###########
##...$........###########
##............###########
##.......##...###########
###########...###########
###########.@.###########
###########___###########