############-############
#.......D..#A...........#
#..D.......#..........D.#
#D..#......#########....#
#...#.....D........#....#
#.D.#..............#....#
#...###########....#....#
#.....D...D...#..D....D.#
#.D..D......@.#.........#
###########___###########