#########################
#...........P...........#
#.......................#
#..##...............##..#
#..##..A.........A..##..#
#.......................#
#......A.........A......#
#..##...............##..#
#..##..A.........A..##..#
#.......................#
#......A.........A......#
#..##...............##..#
#..##..A.........A..##..#
#.......................#
#...........@...........#
###########___###########