###########---###########
#....D......D......D....#
#.......................#
#..###################..#
#..D..#.....D.....#..D..#
#.....#...#...#...#.....#
###..##...#...#...##..###
#.........#.@.#.........#
###########___###########