############-############
#..K....#...L...#....K..#
#.......#.......#.......#
#.......####K####.......#
#..K.K.K.K.K.K.K.K.K.K..#
#K.....................K#
#.....K...........K.....#
#..K.................K..#
#...........@...........#
###########___###########