###########---###########
###########...###########
###########...###########
###########...##.......##
###########........$...##
###########............##
###########...##.......##
###########...###########
###########.@.###########
############_############